18,15
1,1,9,10,3,13
1,1,9,6,3,12
2,1,16,3,3,4
END
.........N....X...
..............X...
..............X...
...X...XXXX...X...
...X..........X...
...X..........X...
...X..........X...
...X...XXXX...X..E
...X..........X...
...X..........X...
...X..........X...
...X...XXXX...X...
...X..............
...X..............
.c.X....S.........
