28,12
1,0,20,6,3,11
1,0,10,6,3,12
0,1,9,2,3,20
2,1,24,12,3,5
END
............N.........XXXXXX
...X............X...........
...X............X...........
...XXXXXXXXXXXXXXXXXXX..X...
................X.......X...
XXXX............X.......X...
........................X...
...XXXXXXXXXXXXXX...XXXXX...
....cX..........X.......X...
...XXX..........X.......X...
....kX..........X.......X...
...XXX..S...................
