18,10
END
........X.N.X.....
........X...X.....
........X...X.....
XXXXXXXX...X......
x..c.......X......
XXXXXXXX...X......
.......X...X......
......X...X.......
......X...X.......
......X.S.X.......
