17,8
1,1,8,2,3,12
0,1,1,2,3,23
END
c...XX...........
....XX...........
XX..XXXXXXX..XX..
XX...........XX..
XX...........XX.E
XX..XXXXXXXXXXXXX
XX.............XX
XX...S.........XX
