46,13
2,1,41,2,3,3
2,1,4,13,3,3
0,1,13,9,3,20
0,1,5,4,3,22
0,1,18,6,3,18
0,1,34,5,3,19
0,1,36,10,3,21
END
XXXX...............N......................XXXX
XXXX......................................XXXX
XXXXXXXXXXXXXXXXXX...XXXXXXXXXXXXXXXXXXXXXXXXX
XXX..............X...X...............XX...cXXX
XXXX...XX.....XX.........XX...XX.....XX...XXXX
...X...XX.....XX.....XX..XX...XX..........X...
W..........XX........XX..........XX..........E
...X.......XX...XX.........XX....XX...XX..X...
XXXX...XX.......XX....XX...XX.........XX..XXXX
XXX....XX.............XX......X...X........XXX
XXXXXXXXXXXXXXXXXXXXXXXXXXXXXXX...XXXXXXXXXXXX
XXXX......................................XXXX
XXXX....c.......................S.........XXXX
