10,10
1,2,5,5,3,9
0,1,0,1,3,20
END
..........
..XXX.X...
......X...
cXXX..X...
......X...
..XXX.X..W
......X...
XXXX..XXXX
..........
....S.....
